111111111111000111111111111
101111000000000000000000001
100111000000000000000000001
100010000000000000000000001
100000001000000000000000001
111000000000000000000000001
100000000000000000000000001
100000000000000000000000001
100000000000000000000000001
100000000000000000000000001
100000000000000000000000001
100000000000000000000000001
100000000000000000000000001
100000000000000000000000001